  0       ******    
  *       *   *     
******* ****  *     
  *   ***     *     
  *   * **********  
  ******         *  
     * *************
     *              
     *              
     *              