******** 0**********            ****
*            *     *            *  * ****
**************     **************  * * **
*                                  * * *
********************               * * *
          *        *               * * *
    *     *        *        ******** * *
    *     *        *        *        * *
    *******        *        *        * *
          *****    *        ********** *
              ******                   *
***************    *    ****************
           *       *    *
           *       *    *
           **************
                   *